{
    "dim_x":16,
    "dim_y":16,
    "grid":[
        592,663,454,610,696,447,530,570,548,600,476,736,742,603,719,733,
        684,418,409,574,460,545,684,635,756,506,560,694,665,420,596,558,
        701,410,623,452,760,483,433,414,706,499,540,413,459,519,410,580,
        576,629,465,659,760,699,437,463,758,526,458,624,615,628,556,656,
        716,618,416,713,739,708,226,243,408,544,474,672,709,593,542,584,
        545,712,496,658,165,121,200,89,108,295,744,683,454,726,523,541,
        752,593,513,278,264,121,316,40,234,86,298,577,666,435,620,604,
        530,428,466,302,179,297,262,334,160,225,71,542,474,408,690,536,
        428,516,448,86,271,359,318,195,16,54,74,531,424,583,585,474,
        577,627,672,456,262,396,75,20,293,376,356,460,611,537,588,731,
        750,574,495,511,247,61,50,221,5,200,124,604,484,447,740,733,
        714,598,723,446,744,673,475,404,742,599,533,470,645,606,578,415,
        546,649,587,542,629,556,564,705,541,417,426,546,740,455,471,421,
        703,466,596,678,665,595,556,434,534,539,671,653,467,528,448,558,
        729,464,528,425,440,647,473,584,464,430,584,473,556,580,671,596,
        659,401,548,596,753,420,655,571,744,618,481,507,440,518,636,614
    ],
    "plant1":{
        "name":"A",
        "best_low":0,
        "best_high":350,
        "live_low":0,
        "live_high":400,
        "max_stage":13,
        "mature_stage":11,
        "multi_season":true
    },
    "plant2":{
        "name":"b",
        "best_low":450,
        "best_high":765,
        "live_low":401,
        "live_high":765,
        "max_stage":7,
        "mature_stage":3,
        "multi_season":false
    }
}